###################################################################
#      #     ######################################################
# P    #               ############################################
#####  #     ######### #################      #####################
#          #     #####                                            #
#       #          ###                  ### #  ###                #
##  #    ##  #####   #                #     #  #    ###           #
#      #    #######  #            ####      #  #                  #
##########          ##           #          # ##                  #
########## ###########          #           # #                   #
##########   ##   ## #       ##             # #        # ##       #
##########      #    #     ##               # #Y            #     #
##########   #########  ##    ##            # #UY                 #
##########   #    YBUB #   #               ## #BUY  #             #
##########     ###########################  #  YBUY##             #
###########################################   #################   #
###############################################################   #
###############################################################   #
###############################################################   #
###############################################################   #
###############################################################   #
###############################################################   #
###############################################################   #
###############################################################   #
###############################################################   #
###############################################################   #
###############################################################   #
###############################################################   #
###############################################################   #
########     ###########################################     ##   #
########              o################################# ###BB   ##
########     ###########################  Y       ###### ##########
#          #     #####                    Y                       #
#       #        #####                    #######                 #
##  #    ##  #########                        #    ##  #          #
#      #    ##########                        #                   #
#   ##################                        #                   #
##         ###########                        #                   #
#########         ####                        #                   #
######    #        ######### #             ####                   #
#       ##   ####  ###      B              # #Y                   #
#   ######   #   #YBUBB     Y#         #   #   B####              #
##           ############################  #### #    #            #
##########################################      ###################
###################################################################