###################################################################
#             #####################################################
#                      ############################################
#      #     ######### ############################################
#    #     #     #####                        #                   #
# #              #####                  ### # #                   #
##  #    ##  #########                #     # #                   #
#  P   #    ##########            ####      # #                   #
##########         ###           #          # #                   #
##########YBU  ###   #          #           # #                   #
##########   ##   ## #       ##             # #                   #
##########      #    #     ##               # #Y                  #
##########   #########  ##    ##            # #UY                 #
##########   #    YBUB #   #                # #BUY  #             #
##########     ############################ #  YBUY##            o#
###################################################################