#########################################################################################################
#########################################################################################################
#########################################################################################################
#########################################################################################################
# P                  #####         #                                                                    #
######    ######################   #                                                                    #
#######  #################       #                                                                      #
#######  ##############################################   #                                             #
#######  #################                                   #                                          #
#######   ################                             #  # #                                           #
########             #####                            #                                                 #
#################### #####   # # #  # #   # # #  ###                                                    #
####################        #                       #                          o                        #
#########################################################################################################
#########################################################################################################
#########################################################################################################
#########################################################################################################