###################################################################
#            ######################################################
#            ######################################################
#                #####                        #                   #
# #              #####                  ### # #                   #
##      ## # #########                #     # #                   #
#  P   #     #########            ####      # #                   #
##########   Y     ###           #          # #                   #
##########YBU  ###   #          #           # #                   #
##########   ##   ## #       ##             # #                   #
##########      #    #     ##               # #Y                  #
##########   #########  ##    ##            # #UY                 #
##########   #    YBUB #   #                # #BUY  #             #
##########     ############################ #  YBUY##            o#
###################################################################