############################################################################
############################################################################
############################################################################
############################################################################
############################################################################
######      #     ##########################################################
###### P    #      1    2   ################################################
##########  #     ######### #################      #########################
######          #     #####                   3                        #####
######       #          ###                  ### #  ###                #####
#######  #    ##  #####   #    E        1  #     #  #    ###           #####
######  E   #    #######  #            ####      #  #                  #####
###############  1   E   ##           #          # ##                  #####
############### ###########          #           # #                   #####
###############   ##   ## #       ##             # #        # ##       #####
###############      #    #     ##          E    # #Y            #     #####
###############   #########  ##    ##            # #UY                 #####
###############   #    YBUB #   #               ## #BUY  #             #####
###############     ###########################  #  YBUY##             #####
################################################   #################   #####
####################################################################   #####
####################################################################   #####
####################################################################   #####
####################################################################   #####
####################################################################   #####
####################################################################   #####
####################################################################   #####
####################################################################   #####
####################################################################   #####
####################################################################   #####
####################################################################   #####
####################################################################   #####
####################################################################   #####
#############     ###########################################     ##   #####
#############              o################################# ###BB   ######
#############     ###########################  Y       ###### ##############
######          #     #####                    Y                       #####
######       #        #####                    #######                 #####
#######  #    ##  #########                        #    ##  #          #####
######      #    ##########                        #                   #####
######   ##################                        #                   #####
#######         ###########                        #                   #####
##############         ####                        #                   #####
###########    #        ######### #             ####                   #####
######       ##   ####  ###      B              # #Y                   #####
######   ######   #   #YBUBB     Y#         #   #   B####              #####
#######           ############################  #### #    #            #####
###############################################      #######################
############################################################################
############################################################################
############################################################################
############################################################################
############################################################################