##############
#            #
#            #
#            #
# #          #
##     ##    #
#  P  #      #
##########   #
##########YBU#
##############
