###########################################################################################################
###########################################################################################################
###########################################################################################################
###########################################################################################################
# P                  #####         #                          ###                                         #
######    ######################   #                          ###                                         #
#######  #################       #                            ###                                         #
#######  ##############################################   #                 #                             #
#######  #################                                   ####    #  #                                 #
#######   ################                             #  # # ### ###    #   ####  #                      #
########             #####                            #       ###                  #                      #
#################### #####   # # #  # #   # # #  ###          ###                  ###                    #
####################        #                        #        ###                                         #
################################################################# #########################################
################################################################# #########################################
#################################################################     o####################################
###########################################################################################################