##############
#            #
#            #
#            #
# #          #
##     ##    #
#  P  #      #
##########   #
##########   #
##############
