############################################################################
############################################################################
############################################################################
############################################################################
#####Y######################################################################
#####BU     #     ##########################################################
#### USP +  #      1    2   ################################################
#### YU###  #     ######### #################      #########################
#### #          #     #####                   3                        #####
#### #       #          ###                  ### #  ###                #####
#### ##  #    ##  #####   #    E        1  #     #  #    ###           #####
#### #  E   #    #######  #            ####      #  #                  #####
#### ##########  1   E   ##           #          # ##                  #####
#### ########## ###########          #           # #                   #####
#### ##########   ##   ## #       ##             # #        # ##       #####
#### ##########      #    #     ##          E    # #Y            #     #####
#### ##########   #########  ##    ##            # #UY                 #####
#### ##########   #    YBUB #   #               ## #BUY  #             #####
#### ##########     ###########################  #  YBUY##             #####
#### ###########################################   #################   #####
#### ###############################################################   #####
#### ###############################################################   #####
#### ###############################################################   #####
#### ###############################################################   #####
#### ###############################################################   #####
#### ###############################################################   #####
#### ###############################################################   #####
#### ###############################################################   #####
#### ###############################################################   #####
#### ###############################################################   #####
#### ###############################################################   #####
#### ###############################################################   #####
#### ###############################################################   #####
#### ########     ###########################################     ##   #####
#### ########              o################################# ###BB   ######
#### ########     ###########################  Y       ###### ##############
####            #     #####                    Y                       #####
######       #        #####                    #######                 #####
#######  #    ##  #########                        #    ##  #          #####
######      #    ##########                        #                   #####
######   ##################                        #                   #####
#######         ###########                        #                   #####
##############         ####                        #                   #####
###########    #        ######### #             ####                   #####
######       ##   ####  ###      B              # #Y                   #####
######   ######   #   #YBUBB     Y#         #   #   B####              #####
#######           ############################  #### #    #            #####
###############################################      #######################
############################################################################
############################################################################
############################################################################
############################################################################
############################################################################