###################
#            ######
#            ######
#                ##
# #             o##
##      ## # ######
#  P   #     ######
##########        #
##########YBU######
###################
