###################################################################
#             #####################################################
#                      ############################################
#      #     ######### #################      #####################
#    #     #     #####                                            #
# #   E   1  2 3 #####                  ### #   ##                #
##  #    ##  #########                #     # #     ###           #
#  P   #    ##########            ####      # #         ##        #
##########         ###           #          # #             #     #
##########YBU  ###   #          #           # #           #       #
##########   ##   ## #       ##             # #        #         o#
########## E    #    #     ##               # #Y          #   #  ##
##########   #########  ##    ##            # #UY                 #
##########   #    YBUB #   #        E       # #BUY  #             #
##########     ############################ #  YBUY##             #
###################################################################
