###################################################################
#             #####################################################
#                      ############################################
#      #     ######### #################      #####################
#    #     #     #####                        #                   #
# #   E          #####                  ### #   ##                #
##  #    ##  #########                #     # #     ###           #
#  P  o#    ##########            ####      # #                   #
##########         ###           #          # #                   #
##########YBU  ###   #          #           # #                   #
##########   ##   ## #       ##             # #        # ##       #
########## E    #    #     ##               # #Y            #     #
##########   #########  ##    ##            # #UY                 #
##########   #    YBUB #   #        E       # #BUY  #             #
##########     ############################ #  YBUY##             #
###################################################################
