###################################################################
#             #####################################################
#                      ############################################
#      #     ######### #################      #####################
#    #     #     #####                                            #
# #   E   1  2 3 #####                  ### #   ##                #
##  #    ##  #########                #     # #     ###           #
#  P   #    ##########            ####      # #                   #
##########         ###           #          # #                   #
##########YBU  ###   #          #           # #                   #
##########   ##   ## #       ##             # #        # ##       #
########## E    #    #     ##               # #Y            #     #
##########   #########  ##    ##            # #UY                 #
##########   #    YBUB #   #        E       # #BUY  #             #
##########     ############################ #  YBUY##            o#
###################################################################
