##############################
##############################
##############################
###                        ###
###        BYU             ###
###       ####### E ###   o###
##############################
##############################
##############################
